##################
##################
##################
#=.#=.############
##..#..###########
###..#..##########
####..#..#.......#
#####..#.#%#####o#
######o..........#
#####..#.##.######
####..#..##..#####
###..#..####..####
##..#..######..###
#\.#..########.=##
##################
##################
##################
##################
